"Normal"
MMMMMMMMM
MS.BMMMMM
M..B..D.M
M..M.KM.M
M..MM..KM
M..T....M
MMMMMDMMM
MMM....MM
MMMT.MMMM
MMMMMMMMM
