"Normal"
MMMMMMMMMM
M...BB...M
M...M....M
M..MT....M
M..TMM..MM
M..M.TM..M
M..M.....M
M..M.....M
M..B....SM
MMMMMMMMMM
