"Facile"
MMMMMMMMMM
MS.D.....M
M.BM.....M
MK.MK...TM
MDMMMMMMMM
M....D...M
M.B..M...M
M...KM...M
MMMMMMMMTM
MMMMMMMMMM
