"Facile"
MMMMMMMMMM
MSMMMMMMMM
M.MMMMMMTM
M........M
M........M
MBMMMMMMBM
M........M
M.......BM
MTMMMMMMTM
MMMMMMMMMM
