"Difficil"
MMMMMMMMMM
MS...MMMMM
MBBBB...KM
M........M
MDMMDMMMDM
M....M..KM
MDM..M..KM
MTM..MT.BM
MTMT...KTM
MMMMMMMMMM
