"Normal"
MMMMMMMMMM
MS...MMMMM
M.BB....KM
M........M
MDMMMMMMDM
M....M...M
M.M..M..KM
MTM.TM..BM
MMMMMMMMTM
MMMMMMMMMM
