"Normal"
MMMMMMMMMM
MS...MMMMM
MBB.....KM
M........M
MDMMMMMMDM
M....M...M
M.M..M..KM
MTM..M..BM
MTD....KTM
MMMMMMMMMM
